t t t t t t t e e t t t t t t t
t t t t d t t e e t t t t t t t
t t t t e e e e e t t t t t t t
t t t e e e e e e t t t t t t t
t t e e e e e e e t t t t t t t
e e e e e e e e e e e e e e e e
t t e e e e e e e e e e e e t t
t t e e e e e e e e e e e e t t
t t e e e e e e e e e e e e t t
t t t t t t t t t t t t t t t t
t t t t t t t t t t t t t t t t